111111111111
100000000001
10000000C001
10000E000001
100000000001
10000000P001
100000000001
111111111111
