111111111111
100000000001
10000000C001
10000E000001
100000000001
1000000P0001
100000000001
111111111111
